#############################################################/
#-----------------------------------------------------------#/
#-----------------------------------------------------------#/
#--+++++++++++++++++++++--+++++++++++++++--+++++++++++++++--#/
#--+++++++++++++++++++++--+++++++++++++++--+++++++++++++++--#/
#--+++++++++++++++++++++--+++++++++++++++--+++++++++++++++--#/
#--+++++++++++++++++++++--+++++++++++++++--+++++++++++++++--#/
#--+++++++++++++++++++++--+++++++++++++++--+++++++++++++++--#/
#--+++++++++++++++++++++--+++++++++++++++--+++++++++++++++--#/
#--+++++++++++++++++++++--+++++++++++++++--+++++++++++++++--#/
#--+++++++++++++++++++++--+++++++++++++++--+++++++++++++++--#/
#--+++++++++++++++++++++--+++++++++++++++--+++++++++++++++--#/
#--+++++++++++++++++++++--+++++++++++++++--+++++++++++++++--#/
#--+++++++++++++++++++++--+++++++++++++++--+++++++++++++++--#/
#--+++++++++++++++++++++--+++++++++++++++--+++++++++++++++--#/
#--+++++++++++++++++++++--+++++++++++++++--+++++++++++++++--#/
#--+++++++++++++++++++++--+++++++++++++++--+++++++++++++++--#/
#--+++++++++++++++++++++--+++++++++++++++--+++++++++++++++--#/
#--+++++++++++++++++++++--+++++++++++++++--+++++++++++++++--#/
#--+++++++++++++++++++++--+++++++++++++++--+++++++++++++++--#/
#--+++++++++++++++++++++--+++++++++++++++--+++++++++++++++--#/
#-----------------------------------------------------------#/
#-----------------------------------------------------------#/
#--+++++++++++++++++++++--+++++++++++++++--+++++++++++++++--#/
#--+++++++++++++++++++++--+++++++++++++++--+++++++++++++++--#/
#--+++++++++++++++++++++--+++++++++++++++--+++++++++++++++--#/
#--+++++++++++++++++++++--+++++++++++++++--+++++++++++++++--#/
#--+++++++++++++++++++++--+++++++++++++++--+++++++++++++++--#/
#--+++++++++++++++++++++--+++++++++++++++--+++++++++++++++--#/
#--+++++++++++++++++++++--+++++++++++++++--+++++++++++++++--#/
#--+++++++++++++++++++++--+++++++++++++++--+++++++++++++++--#/
#--+++++++++++++++++++++--+++++++++++++++--+++++++++++++++--#/
#--+++++++++++++++++++++--+++++++++++++++--+++++++++++++++--#/
#--+++++++++++++++++++++--+++++++++++++++--+++++++++++++++--#/
#--+++++++++++++++++++++--+++++++++++++++--+++++++++++++++--#/
#--+++++++++++++++++++++--+++++++++++++++--+++++++++++++++--#/
#--+++++++++++++++++++++--+++++++++++++++--+++++++++++++++--#/
#--+++++++++++++++++++++--+++++++++++++++--+++++++++++++++--#/
#--+++++++++++++++++++++--+++++++++++++++--+++++++++++++++--#/
#--+++++++++++++++++++++--+++++++++++++++--+++++++++++++++--#/
#--+++++++++++++++++++++--+++++++++++++++--+++++++++++++++--#/
#-----------------------------------------------------------#/
#-----------------------------------------------------------#/
#--+++++++++++++++++++++--+++++++++++++++--+++++++++++++++--#/
#--+++++++++++++++++++++--+++++++++++++++--+++++++++++++++--#/
#--+++++++++++++++++++++--+++++++++++++++--+++++++++++++++--#/
#--+++++++++++++++++++++--+++++++++++++++--+++++++++++++++--#/
#--+++++++++++++++++++++--+++++++++++++++--+++++++++++++++--#/
#--+++++++++++++++++++++--+++++++++++++++--+++++++++++++++--#/
#--+++++++++++++++++++++--+++++++++++++++--+++++++++++++++--#/
#--+++++++++++++++++++++--+++++++++++++++--+++++++++++++++--#/
#--+++++++++++++++++++++--+++++++++++++++--+++++++++++++++--#/
#--+++++++++++++++++++++--+++++++++++++++--+++++++++++++++--#/
#--+++++++++++++++++++++--+++++++++++++++--+++++++++++++++--#/
#--+++++++++++++++++++++--+++++++++++++++--+++++++++++++++--#/
#--+++++++++++++++++++++--+++++++++++++++--+++++++++++++++--#/
#--+++++++++++++++++++++--+++++++++++++++--+++++++++++++++--#/
#--+++++++++++++++++++++--+++++++++++++++--+++++++++++++++--#/
#--+++++++++++++++++++++--+++++++++++++++--+++++++++++++++--#/
#--+++++++++++++++++++++--+++++++++++++++--+++++++++++++++--#/
#--+++++++++++++++++++++--+++++++++++++++--+++++++++++++++--#/
#-----------------------------------------------------------#/
#-----------------------------------------------------------#/
#############################################################/