############################################/
#------------------------------------------#/
#------------------------------------------#/
#--+++++++++++++++++++++--+++++++++++++++--#/
#--+++++++++++++++++++++--+++++++++++++++--#/
#--+++++++++++++++++++++--+++++++++++++++--#/
#--+++++++++++++++++++++--+++++++++++++++--#/
#--+++++++++++++++++++++--+++++++++++++++--#/
#--+++++++++++++++++++++--+++++++++++++++--#/
#--+++++++++++++++++++++--+++++++++++++++--#/
#--+++++++++++++++++++++--+++++++++++++++--#/
#--+++++++++++++++++++++--+++++++++++++++--#/
#--+++++++++++++++++++++--+++++++++++++++--#/
#--+++++++++++++++++++++--+++++++++++++++--#/
#--+++++++++++++++++++++--+++++++++++++++--#/
#--+++++++++++++++++++++--+++++++++++++++--#/
#--+++++++++++++++++++++--+++++++++++++++--#/
#--+++++++++++++++++++++--+++++++++++++++--#/
#--+++++++++++++++++++++--+++++++++++++++--#/
#--+++++++++++++++++++++--+++++++++++++++--#/
#--+++++++++++++++++++++--+++++++++++++++--#/
#------------------------------------------#/
#------------------------------------------#/
#--+++++++++++++++++++++--+++++++++++++++--#/
#--+++++++++++++++++++++--+++++++++++++++--#/
#--+++++++++++++++++++++--+++++++++++++++--#/
#--+++++++++++++++++++++--+++++++++++++++--#/
#--+++++++++++++++++++++--+++++++++++++++--#/
#--+++++++++++++++++++++--+++++++++++++++--#/
#--+++++++++++++++++++++--+++++++++++++++--#/
#--+++++++++++++++++++++--+++++++++++++++--#/
#--+++++++++++++++++++++--+++++++++++++++--#/
#--+++++++++++++++++++++--+++++++++++++++--#/
#--+++++++++++++++++++++--+++++++++++++++--#/
#--+++++++++++++++++++++--+++++++++++++++--#/
#--+++++++++++++++++++++--+++++++++++++++--#/
#--+++++++++++++++++++++--+++++++++++++++--#/
#--+++++++++++++++++++++--+++++++++++++++--#/
#--+++++++++++++++++++++--+++++++++++++++--#/
#--+++++++++++++++++++++--+++++++++++++++--#/
#--+++++++++++++++++++++--+++++++++++++++--#/
#------------------------------------------#/
#------------------------------------------#/
#--+++++++++++++++++++++--+++++++++++++++--#/
#--+++++++++++++++++++++--+++++++++++++++--#/
#--+++++++++++++++++++++--+++++++++++++++--#/
#--+++++++++++++++++++++--+++++++++++++++--#/
#--+++++++++++++++++++++--+++++++++++++++--#/
#--+++++++++++++++++++++--+++++++++++++++--#/
#--+++++++++++++++++++++--+++++++++++++++--#/
#--+++++++++++++++++++++--+++++++++++++++--#/
#--+++++++++++++++++++++--+++++++++++++++--#/
#--+++++++++++++++++++++--+++++++++++++++--#/
#--+++++++++++++++++++++--+++++++++++++++--#/
#--+++++++++++++++++++++--+++++++++++++++--#/
#--+++++++++++++++++++++--+++++++++++++++--#/
#--+++++++++++++++++++++--+++++++++++++++--#/
#--+++++++++++++++++++++--+++++++++++++++--#/
#--+++++++++++++++++++++--+++++++++++++++--#/
#--+++++++++++++++++++++--+++++++++++++++--#/
#--+++++++++++++++++++++--+++++++++++++++--#/
#------------------------------------------#/
#------------------------------------------#/
############################################/