###########################/
#-------------------------#/
#-------------------------#/
#--+++++++++++++++++++++--#/
#--+++++++++++++++++++++--#/
#--+++++++++++++++++++++--#/
#--+++++++++++++++++++++--#/
#--+++++++++++++++++++++--#/
#--+++++++++++++++++++++--#/
#--+++++++++++++++++++++--#/
#--+++++++++++++++++++++--#/
#--+++++++++++++++++++++--#/
#--+++++++++++++++++++++--#/
#--+++++++++++++++++++++--#/
#--+++++++++++++++++++++--#/
#--+++++++++++++++++++++--#/
#--+++++++++++++++++++++--#/
#--+++++++++++++++++++++--#/
#--+++++++++++++++++++++--#/
#--+++++++++++++++++++++--#/
#--+++++++++++++++++++++--#/
#-------------------------#/
#-------------------------#/
#--+++++++++++++++++++++--#/
#--+++++++++++++++++++++--#/
#--+++++++++++++++++++++--#/
#--+++++++++++++++++++++--#/
#--+++++++++++++++++++++--#/
#--+++++++++++++++++++++--#/
#--+++++++++++++++++++++--#/
#--+++++++++++++++++++++--#/
#--+++++++++++++++++++++--#/
#--+++++++++++++++++++++--#/
#--+++++++++++++++++++++--#/
#--+++++++++++++++++++++--#/
#--+++++++++++++++++++++--#/
#--+++++++++++++++++++++--#/
#--+++++++++++++++++++++--#/
#--+++++++++++++++++++++--#/
#--+++++++++++++++++++++--#/
#--+++++++++++++++++++++--#/
#-------------------------#/
#-------------------------#/
###########################/