###########################/
#-------------------------#/
#>>>>>>>>>>>>>>>>>>>>>>>v-#/
#-^+++++++++++++++++++++v-#/
#-^+++++++++++++++++++++v-#/
#-^+++++++++++++++++++++v-#/
#-^+++++++++++++++++++++v-#/
#-^+++++++++++++++++++++v-#/
#-^+++++++++++++++++++++v-#/
#-^+++++++++++++++++++++v-#/
#-^+++++++++++++++++++++v-#/
#-^+++++++++++++++++++++v-#/
#-^+++++++++++++++++++++v-#/
#-^+++++++++++++++++++++v-#/
#-^+++++++++++++++++++++v-#/
#-^+++++++++++++++++++++v-#/
#-^+++++++++++++++++++++v-#/
#-^+++++++++++++++++++++v-#/
#-^+++++++++++++++++++++v-#/
#-^+++++++++++++++++++++v-#/
#-^+++++++++++++++++++++v-#/
#-^<<<<<<<<<<<<<a<<<<<<<a<#/
#-b>>>>>>>>>>>>>>>>>>>>>v-#/
#-^+++++++++++++++++++++v-#/
#-^+++++++++++++++++++++v-#/
#-^+++++++++++++++++++++v-#/
#-^+++++++++++++++++++++v-#/
#-^+++++++++++++++++++++v-#/
#-^+++++++++++++++++++++v-#/
#-^+++++++++++++++++++++v-#/
#-^+++++++++++++++++++++v-#/
#-^+++++++++++++++++++++v-#/
#-^+++++++++++++++++++++v-#/
#-^+++++++++++++++++++++v-#/
#-^+++++++++++++++++++++v-#/
#-^+++++++++++++++++++++v-#/
#-^+++++++++++++++++++++v-#/
#-^+++++++++++++++++++++v-#/
#-^+++++++++++++++++++++v-#/
#-^+++++++++++++++++++++v-#/
#-^+++++++++++++++++++++v-#/
#-^<<<<<<<<<<<<<<<<<<<<<<-#/
#-^---------------------^<#/
###########################/