#############################/
##--------------------------#/
#---------------------------#/
#--+++++++++++++++++++++----#/
#--+++++++++++++++++++++----#/
#--+++++++++++++++++++++----#/
#--+++++++++++++++++++++----#/
#--+++++++++++++++++++++----#/
#--+++++++++++++++++++++----#/
#--+++++++++++++++++++++----#/
#--+++++++++++++++++++++----#/
#--+++++++++++++++++++++----#/
#--+++++++++++++++++++++----#/
#--+++++++++++++++++++++----#/
#--+++++++++++++++++++++----#/
#--+++++++++++++++++++++----#/
#--+++++++++++++++++++++----#/
#--+++++++++++++++++++++----#/
#--+++++++++++++++++++++----#/
#--+++++++++++++++++++++----#/
#--+++++++++++++++++++++----#/
#---------------------------#/
##--------------------------#/
#############################/